11 2 2 2 2 2 2 2 2 2 2 2 2 10 11 2 2 2 2 2 2 2 2 2 2 2 2 10
4 0 0 0 0 0 0 0 0 0 0 0 0 5 4 0 0 0 0 0 0 0 0 0 0 0 0 5
4 0 8 3 3 9 0 8 3 3 3 9 0 5 4 0 8 3 3 3 9 0 8 3 3 9 0 5
4 0 5 1 1 4 0 5 1 1 1 4 0 5 4 0 5 1 1 1 4 0 5 1 1 4 0 5
4 0 6 2 2 7 0 6 2 2 2 7 0 6 7 0 6 2 2 2 7 0 6 2 2 7 0 5
4 0 0 0 0 0 0 0 0 0 0 0 0 0 0 0 0 0 0 0 0 0 0 0 0 0 0 5
4 0 8 3 3 9 0 8 9 0 8 3 3 3 3 3 3 9 0 8 9 0 8 3 3 9 0 5
4 0 6 2 2 7 0 5 4 0 6 2 2 10 11 2 2 7 0 5 4 0 6 2 2 7 0 5
4 0 0 0 0 0 0 5 4 0 0 0 0 5 4 0 0 0 0 5 4 0 0 0 0 0 0 5
13 3 3 3 3 9 0 5 13 3 3 9 0 5 4 0 8 3 3 12 4 0 8 3 3 3 3 12
1 1 1 1 1 4 0 5 11 2 2 7 0 6 7 0 6 2 2 10 4 0 5 1 1 1 1 1
1 1 1 1 1 4 0 5 4 0 0 0 0 0 0 0 0 0 0 5 4 0 5 1 1 1 1 1
1 1 1 1 1 4 0 5 4 0 8 3 3 3 3 3 3 9 0 5 4 0 5 1 1 1 1 1
2 2 2 2 2 7 0 6 7 0 5 11 2 2 2 2 10 4 0 6 7 0 6 2 2 2 2 2
0 0 0 0 0 0 0 0 0 0 5 4 0 0 0 0 5 4 0 0 0 0 0 0 0 0 0 0
3 3 3 3 3 9 0 8 9 0 5 13 3 3 3 3 12 4 0 8 9 0 8 3 3 3 3 3
1 1 1 1 1 4 0 5 4 0 6 2 2 2 2 2 2 7 0 5 4 0 5 1 1 1 1 1
1 1 1 1 1 4 0 5 4 0 0 0 0 0 0 0 0 0 0 5 4 0 5 1 1 1 1 1
1 1 1 1 1 4 0 5 4 0 8 3 3 3 3 3 3 9 0 5 4 0 5 1 1 1 1 1
11 2 2 2 2 7 0 6 7 0 6 2 2 10 11 2 2 7 0 6 7 0 6 2 2 2 2 10
4 0 0 0 0 0 0 0 0 0 0 0 0 5 4 0 0 0 0 0 0 0 0 0 0 0 0 5
4 0 8 3 3 9 0 8 3 3 3 9 0 5 4 0 8 3 3 3 9 0 8 3 3 9 0 5
4 0 6 2 10 4 0 6 2 2 2 7 0 6 7 0 6 2 2 2 7 0 5 11 2 7 0 5
4 0 0 0 5 4 0 0 0 0 0 0 0 0 0 0 0 0 0 0 0 0 5 4 0 0 0 5
13 3 9 0 5 4 0 8 9 0 8 3 3 3 3 3 3 9 0 8 9 0 5 4 0 8 3 12
11 2 7 0 6 7 0 5 4 0 6 2 2 10 11 2 2 7 0 5 4 0 6 7 0 6 2 10
4 0 0 0 0 0 0 5 4 0 0 0 0 5 4 0 0 0 0 5 4 0 0 0 0 0 0 5
4 0 8 3 3 3 3 12 13 3 3 9 0 5 4 0 8 3 3 12 13 3 3 3 3 9 0 5
4 0 6 2 2 2 2 2 2 2 2 7 0 6 7 0 6 2 2 2 2 2 2 2 2 7 0 5
4 0 0 0 0 0 0 0 0 0 0 0 0 0 0 0 0 0 0 0 0 0 0 0 0 0 0 5
13 3 3 3 3 3 3 3 3 3 3 3 3 3 3 3 3 3 3 3 3 3 3 3 3 3 3 12